Nearest to values(): resume() , getPath() ,
Nearest to close(): getUser() , getStatus() ,
Nearest to getConf(): isAbsoluteAndSchemeAuthorityNull() ,
Nearest to reset(): getSize() , getAMRMToken() ,
Nearest to toString(): getLocationInfo() ,
Nearest to getWorkingDirectory(): getFailedRequests() ,
Nearest to hashCode(): getMaxMapAttempts() , getDefaultPort() ,
Nearest to get(): getConfiguration() , isAbsoluteAndSchemeAuthorityNull() , incr() ,
Nearest to stop():
Nearest to getLength(): getContainerToken() , getJobState() ,
Nearest to nextKeyValue():
Nearest to getProgress(): getCanonicalUri() , getFailureState() , type() , getMaxReduceAttempts() ,
Nearest to getCurrentValue(): getQueueState() , getMapOutputKeyClass() ,
Nearest to getCurrentKey(): emit(org.apache.hadoop.mapreduce.lib.join.TupleWritable) , getCapacity() , getFieldTypeInfos() , getDefaultBlockSize() , getWorkingDirectory() ,
Nearest to getUri(): getMemoryForReduceTask() ,
Nearest to getName():
Nearest to getHomeDirectory(): getTTExpiryInterval() , getSystemDir() , getPermission() ,
Nearest to getScheme():
Nearest to getBytes():
Nearest to getApplicationId(): getContainerToken() , getMapOutputValueClass() ,
Nearest to incr():
Nearest to getKind(): getMemoryForReduceTask() ,
Nearest to finished():
Nearest to getUser(): getStatus() , close() , getMapDebugScript() ,
Nearest to getPriority():
Nearest to getRemaining():
Nearest to getId(): finished() ,
Nearest to supportsSymlinks(): getMaximumResourceCapability() , getApplicationAttemptId() ,
Nearest to hasNext(): getMaxMapAttempts() , waitForCompletion() , isUriPathAbsolute() ,
Nearest to clear(): getCachePoolDefault() , start() , getKeepTaskFilesPattern() , getFinishTime() , createCompressor() ,
Nearest to flush():
Nearest to getStartTime(): getContainerId() , resetState() , getMemoryForMapTask() , getBeginLine() ,
Nearest to start(): clear() ,
Nearest to serviceStop():
Nearest to getQueueName(): getResourceKey() , getMemoryForReduceTask() , getMapDebugScript() ,
Nearest to getDefaultBlockSize(): getCurrentKey() , getOccupiedReduceSlots() , getCapacity() ,
Nearest to getLocations(): size() ,
Nearest to getHost():
Nearest to resetState(): getStartTime() ,
Nearest to getJobName(): run(org.apache.hadoop.mapreduce.Reducer.Context) ,
Nearest to needsInput(): getInstance() , waitForCompletion() ,
Nearest to getPos(): getTaskCleanupNeeded() , hsync() ,
Nearest to getTrackingUrl():
Nearest to getInstance(): needsInput() ,
Nearest to getServerDefaults():
Nearest to getQueue(): getAllStatistics() , getProfileEnabled() ,
Nearest to serviceStart(): processDeleteOnExit() , shutdown() ,
Nearest to getApplicationAttemptId(): getDelegate() ,
Nearest to getMaxReduceAttempts(): getUriDefaultPort() , getTaskTrackerCount() , getProgress() ,
Nearest to getMemoryForMapTask(): getDisplayName() , getStartTime() , getEmptier() ,
Nearest to getFailureCause(): getContainerId() ,
Nearest to getJobID():
Nearest to copyBytes(): isAbsoluteAndSchemeAuthorityNull() , isEncrypted() ,
Nearest to getDecompressorType():
Nearest to getReservationId(): getDelegate() ,
Nearest to createValue(): getLen() , getContainerState() ,
Nearest to getDiagnostics(): getName() , getJobSetupCleanupNeeded() ,
Nearest to getInitialWorkingDirectory():
Nearest to not():
Nearest to finish(): setupProgress() ,
Nearest to getMemoryForReduceTask(): getKind() , getJobPriority() , getContainerIds() , getQueueName() ,
Nearest to createDecompressor(): getIncludeChildQueues() ,
Nearest to isSymlink():
Nearest to getUsed(): disable_tracing() , getEndColumn() ,
Nearest to getDefaultExtension(): createCompressor() , getFileSystemInstanceId() ,
Nearest to getDisplayName(): getMemoryForMapTask() , getFailureState() , getConfiguration() , getDecommissionedTaskTrackerCount() ,
Nearest to createCompressor(): getDefaultExtension() , getCanonicalUri() , clear() ,
Nearest to getCapacity(): getCurrentKey() ,
Nearest to getCompressorType(): toShort() ,
Nearest to getContainerId(): getStartTime() , id() , getFailureCause() ,
Nearest to getMaxMapAttempts(): hasNext() , hashCode() ,
Nearest to getFinishTime(): getApplicationId() , clear() ,
Nearest to getContainers():
Nearest to getApplications(): getFailureInfo() ,
Nearest to run():
Nearest to getCombinerKeyGroupingComparator():
Nearest to getDefaultReplication(): getMaximumResourceCapability() ,
Nearest to getCanonicalServiceName():
Nearest to id(): getContainerId() ,
Nearest to getPermission(): getReservationDefinition() , getHomeDirectory() ,
Nearest to monitorAndPrintJob(): getLocationInfo() ,
Nearest to getJobFile():
Nearest to getAllJobStatuses(): shutdown() ,
Nearest to getOwner(): end() ,
Nearest to getUriDefaultPort(): getTaskTrackerCount() , getMaxReduceAttempts() , getContainerToken() , getContainers() ,
Nearest to createDirectDecompressor(): getNumExcludedNodes() , getOutputKeyClass() ,
Nearest to getMessage():
Nearest to getEntityType(): isRetired() ,
Nearest to waitForCompletion(): hasNext() , getInstance() , needsInput() , getIncludeApplications() ,
Nearest to getDelegate(): getReservationId() , getFailureInfo() , getApplicationAttemptId() ,
Nearest to getStatus(): getUser() , close() , getProfileEnabled() , getAccessTime() ,
Nearest to printStatistics(): getMapOutputKeyClass() , getContainerToken() ,
Nearest to getFailedRequests(): getWorkingDirectory() , getRelaxLocality() ,
Nearest to decr(): getEntities() , resume() ,
Nearest to getEntityId(): getEvents() , publishMetricsNow() ,
Nearest to getTypes():
Nearest to reloadCachedMappings(): getNextToken() , isComplete() ,
Nearest to getResource(): getAvailableResources() , getBlackListedTaskTrackers() ,
Nearest to getAvailableResources(): isComplete() , getBlackListedTaskTrackers() ,
Nearest to size(): getLocations() ,
Nearest to getSelectQuery():
Nearest to getState(): getUri() ,
Nearest to getNodeId():
Nearest to clone(): getClientAcls() , copyBytes() ,
Nearest to getRpcPort():
Nearest to getAllStatistics(): getQueue() ,
Nearest to getCapability(): isSuccessful() , getFileSystemInstanceId() ,
Nearest to getLocationInfo(): toString() , monitorAndPrintJob() ,
Nearest to getSingleton():
Nearest to getPort(): isTransient() ,
Nearest to getProfileEnabled(): getQueue() , getStatus() , getOwner() ,
Nearest to isRetired(): getEntityType() , getLength() ,
Nearest to getStagingAreaDir(): getFinishTime() ,
Nearest to key(): run(org.apache.hadoop.mapreduce.Reducer.Context) ,
Nearest to getNodeLabelExpression():
Nearest to getBlockers():
Nearest to getPartitionerClass():
Nearest to getContainerIds(): getMemoryForReduceTask() , getGroupNames() , getJobStatus() ,
Nearest to isSingleSwitch(): getFileDefault() ,
Nearest to getConfiguration(): getFailureState() , get() , checkpoint() , getQueues() , getWorkingDirectory() ,
Nearest to getLifecycleHistory(): getReaders() , getBytes() ,
Nearest to getDefaultPort(): hashCode() , getReservationDefinition() , createDirectDecompressor() ,
Nearest to clearStatistics(): homePathForCurrentUser() , getInstance() ,
Nearest to getMapOutputKeyClass(): printStatistics() , getCurrentValue() ,
Nearest to getQueueState(): getCurrentValue() , getAllEvents() , getFailureInfo() ,
Nearest to getFieldTypeInfos(): getCurrentKey() , Record() , getTaskCleanupNeeded() , getRawFileSystem() , getWorkingDirectory() , value() ,
Nearest to getJar():
Nearest to getContainerToken(): getLength() , getApplicationId() , printStatistics() , getUriDefaultPort() ,
Nearest to Record(): getFieldTypeInfos() ,
Nearest to getCounters(): hashCode() ,
Nearest to getTrackingURL(): getWorkingDirectory() ,
Nearest to getPath(): values() , clearChanged() , getFsStatus() ,
Nearest to getTimestamp():
Nearest to getGroup():
Nearest to getCount(): mapProgress() , values() ,
Nearest to iterator(): getReaders() , getLifecycleHistory() , getEndLine() ,
Nearest to emit(org.apache.hadoop.mapreduce.lib.join.TupleWritable): getCurrentKey() ,
Nearest to getAppId():
Nearest to getRawFileSystem(): finished() , getTypes() , getFieldTypeInfos() ,
Nearest to isEnabled(): createKey() , homePathForCurrentUser() , getSwitchMap() ,
Nearest to getFailureInfo(): getApplications() , getDelegate() ,
Nearest to getNumContainers(): getProfileParams() ,
Nearest to getRootQueues(): end() , getCapability() , getNMTokenCache() ,
Nearest to getSystemDir(): getHomeDirectory() , getNodeId() , getTTExpiryInterval() ,
Nearest to getJobState(): getLength() ,
Nearest to getClusterTimestamp(): getClusterNodeCount() ,
Nearest to getEvents(): getEntityId() , getLocalCacheArchives() , getLocationInfo() , halfDigest() , publishMetricsNow() ,
Nearest to getContainerLogDir(): shutdown() , getMapDebugScript() ,
Nearest to getFinalApplicationStatus(): getFormatMinSplitSize() ,
Nearest to getJobTrackerStatus(): getFs() ,
Nearest to getTaskType(): getMaxMapTasks() , getId() ,
Nearest to getServiceState(): getCapability() ,
Nearest to getMaximumResourceCapability(): getNodeHttpAddress() , createTupleWritable() , run(org.apache.hadoop.mapreduce.Reducer.Context) ,
Nearest to cleanupProgress(): setRetired() , getReduceTasks() , getDirDefault() , getQueueName() ,
Nearest to reduceProgress(): clone() ,
Nearest to getResponseId(): getFencer() , getUser() ,
Nearest to getType(): getDiagnosticsInfo() , getBlackListedTaskTrackers() , getHistoryUrl() ,
Nearest to mapProgress(): type() , getCount() ,
Nearest to getApplicationTags(): getMetricsCopy() ,
Nearest to getApplicationType():
Nearest to submit():
Nearest to getOutputValueClass(): getApplicationAcls() ,
Nearest to getProfileParams(): getNumContainers() , setRetired() , getMaxMapTasks() ,
Nearest to setupProgress(): finish() ,
Nearest to getAMRMToken(): reset() ,
Nearest to getTaskID(): getNeededResources() , getFinalApplicationStatus() ,
Nearest to hsync(): getPos() , getIdentifier() ,
Nearest to getClusterStatus(): getTokens() ,
Nearest to getReducerClass():
Nearest to getNextToken(): reloadCachedMappings() , getCurrentKey() ,
Nearest to isRecoverySupported():
Nearest to getEmptier(): getMemory() , getMemoryForMapTask() , getApplicationTypes() , getDisplayName() ,
Nearest to getFormatMinSplitSize(): getFinalApplicationStatus() , getMapDebugScript() ,
Nearest to hflush(): newMetricsSourceName() , getMaximumResourceCapability() , getRemaining() , getTaskCleanupNeeded() ,
Nearest to getFileDefault():
Nearest to getSize(): reset() ,
Nearest to getValue(): getBlockSize() , getBlacklistedTrackers() ,
Nearest to isSuccessful(): getCapability() ,
Nearest to getMapOutputValueClass(): getApplicationId() , getAllJobStatuses() ,
Nearest to isTransient():
Nearest to killJob(): getBeginLine() , getSortComparator() ,
Nearest to getOutputCommitter():
Nearest to getSchedulingInfo():
Nearest to getQueues(): getConfiguration() , needsDictionary() ,
Nearest to getAllJobs(): reloadCachedMappings() ,
Nearest to value(): getFieldTypeInfos() ,
Nearest to getChildFileSystems(): not() , getPos() ,
Nearest to getOutputKeyClass():
Nearest to getFsStatus(): getCurrentKey() , getPath() ,
Nearest to getCredentials():
Nearest to isComplete(): getAvailableResources() , reloadCachedMappings() , getResource() ,
Nearest to getCanonicalUri(): getProgress() , createCompressor() , getUri() ,
Nearest to sync():
Nearest to getNodeHttpAddress(): getMaximumResourceCapability() , getContextFactory() ,
Nearest to getDirDefault(): isTypeConsumedAvailable() , cleanupProgress() , getDigest() ,
Nearest to shutdown(): getMaximumResourceCapability() , getContainerLogDir() , getAllJobStatuses() , serviceStart() ,
Nearest to getMapperClass(): homePathForCurrentUser() , flush() ,
Nearest to getHistoryUrl():
Nearest to getNumReduceTasks(): newMetricsSourceName() ,
Nearest to getConfig():
Nearest to getInputSplit(): shutdown() , getArchiveClassPaths() , getContainerLogDir() ,
Nearest to getClusterNodeCount(): getContainerState() , getClusterTimestamp() ,
Nearest to getCombinerClass(): getBlockSize() ,
Nearest to isMap(): getCombinerClass() , stop() ,
Nearest to getNMTokenCache(): getApplicationSubmissionContext() ,
Nearest to getResourceKey(): getQueueName() , getMapDebugScript() , getUser() , close() ,
Nearest to getFailureState(): getConfiguration() , getOutputValueGroupingComparator() , getDisplayName() , getWorkingDirectory() , getProgress() ,
Nearest to getQueueAclsForCurrentUser(): getApplicationType() ,
Nearest to createKey(): isEnabled() ,
Nearest to getReservationDefinition(): getPermission() , getDefaultPort() , hashCode() ,
Nearest to end(): getOwner() , getAccessTime() ,
Nearest to getSwitchMap(): createKey() , isEnabled() ,
Nearest to run(org.apache.hadoop.mapreduce.Reducer.Context): getMaximumResourceCapability() ,
Nearest to getErrors(): getResource() , getInputSplit() ,
Nearest to getOccupiedMapSlots(): getSchedulingInfo() ,
Nearest to getCompletedContainersStatuses(): getStart() , getDomains() , getWorkPath() ,
Nearest to getRolledLogsIncludePattern():
Nearest to getContainerState(): getClusterNodeCount() , createValue() ,
Nearest to getAMContainerSpec(): getMemoryForReduceTask() , getKind() ,
Nearest to getComparator(): makeEscapedCompactString() , getMapOutputKeyClass() , getName() ,
Nearest to getMaxReduceTasks(): publishMetricsNow() , getKeepFailedTaskFiles() , getDigester() ,
Nearest to checkpoint(): getConfiguration() , get() , reset() , getQueues() ,
Nearest to getWorkPath():
Nearest to getCurrentMaximumDownloadBandwidth(): getWorkingDirectory() , getName() ,
Nearest to getApplicationResourceUsageReport():
Nearest to done(): getWorkPath() , getMetricsCopy() ,
Nearest to needsDictionary(): getQueues() ,
Nearest to getClusterHandle():
Nearest to getID():
Nearest to getEndLine(): iterator() ,
Nearest to setChanged(): getTaskCleanupNeeded() ,
Nearest to isEncrypted(): copyBytes() , waitForCompletion() , needsInput() ,
Nearest to getCreationTime(): getDecompressorType() ,
Nearest to getGroupNames(): getContainerIds() , getMemoryForReduceTask() ,
Nearest to getBlackListedTrackersInfo(): toString() , getEvents() , getMessage() ,
Nearest to getMaxReduceTaskFailuresPercent(): getKeyFieldComparatorOption() ,
Nearest to Include(): getJobEndNotificationURI() , getLogAggregationContext() , getScheme() ,
Nearest to clientErrorEncountered():
Nearest to getJarUnpackPattern():
Nearest to getUserInfo(): getUsedMemory() , getFsStatus() , clearChanged() , getDefaultNodeLabelExpression() ,
Nearest to getModifiedTime(): getConf() ,
Nearest to getMaxMemory(): getWorkingDirectory() , getCombinerClass() , getBlockSize() ,
Nearest to getBlockSize(): getTaskCleanupNeeded() , getCombinerClass() , needsInput() ,
Nearest to halfDigest(): getDomains() , getLocationInfo() ,
Nearest to getNumExcludedNodes(): createDirectDecompressor() ,
Nearest to getUseNewReducer(): getReservationId() ,
Nearest to getBlockUploadLatency(): killJob() , isUriPathAbsolute() ,
Nearest to getApplicationName(): isTypeQuotaSet() , getResponseId() , Map() ,
Nearest to getActiveTaskTrackers(): get() , getDiagnostics() , getName() ,
Nearest to directoryDeleted(): finished() , getOutputKeyClass() , getTypes() , getSpaceQuota() ,
Nearest to getSpaceQuota(): getTypes() , getRawFileSystem() ,
Nearest to getElementType(): getOutputValueGroupingComparator() , getContainers() ,
Nearest to getSortComparator():
Nearest to getLocalCacheArchives(): getEvents() ,
Nearest to getApplicationTypes(): getEmptier() , isSymlink() ,
Nearest to getApplicationAttemptReport(): getQueueName() , getResourceKey() , getFs() ,
Nearest to isUriPathAbsolute(): getSymlink() , hasNext() ,
Nearest to Map(): getApplicationName() , getSortComparator() ,
Nearest to getApplicationAcls(): getOutputValueClass() , getJobName() , reloadCachedMappings() ,
Nearest to jobsToComplete(): getOriginalTrackingUrl() ,
Nearest to getTTExpiryInterval(): getHomeDirectory() , getSystemDir() ,
Nearest to getResourceName(): getShouldBeUploadedToSharedCache() ,
Nearest to getIdentifier(): hsync() , shutdown() ,
Nearest to toShort(): getCompressorType() , finished() ,
Nearest to getDescription(): mark() , monitorAndPrintJob() , publishMetricsNow() , getEvents() , isComplete() ,
Nearest to getCumulativeVmem(): getArchiveClassPaths() , getQueue() ,
Nearest to getIsKillCompleted():
Nearest to getKeepFailedTaskFiles(): getMaxReduceTasks() , getDigester() , getPort() , getDiagnosticsInfo() ,
Nearest to getRMDelegationToken(): getMaxReduceAttempts() , getEndColumn() ,
Nearest to getChildQueues(): getTaskTrackers() ,
Nearest to useQueryStringForDelegationToken():
Nearest to getClientAcls(): clone() , getJobPriority() ,
Nearest to getReduceSlotCapacity():
Nearest to makeEscapedCompactString(): getComparator() , printStatistics() , getConf() ,
Nearest to getKeepContainersAcrossApplicationAttempts(): serviceStart() ,
Nearest to run(org.apache.hadoop.mapreduce.Mapper.Context): getDefaultBlockSize() ,
Nearest to getFinalParameters(): start() ,
Nearest to getNodeLabels(): finish() ,
Nearest to getShouldBeUploadedToSharedCache(): getResourceName() ,
Nearest to getMaxMapTasks(): getTaskType() , getProfileParams() , getRpcPort() ,
Nearest to publishMetricsNow(): getMaxReduceTasks() ,
Nearest to Input(): getDecompressorType() , usage() , getVersion() ,
Nearest to getDomainId(): submit() ,
Nearest to getJobPriority(): getMemoryForReduceTask() , getClientAcls() ,
Nearest to getClassLoader(): getTaskTrackers() , getServiceState() ,
Nearest to newMetricsSourceName(): incr() , hflush() , getNumReduceTasks() ,
Nearest to getApplicationSubmissionContext(): getNMTokenCache() , getCapability() , getRootQueues() , getServiceState() , getInitialWorkingDirectory() , getCurrentValue() ,
Nearest to getMapSlotCapacity():
Nearest to getSchedulerResourceTypes(): getReduceTasks() ,
Nearest to findTimestampedDirectories(): newMetricsSourceName() , emit(org.apache.hadoop.mapreduce.lib.join.TupleWritable) , hflush() , getCurrentKey() , getRemaining() ,
Nearest to processDeleteOnExit(): serviceStart() ,
Nearest to getKeyFieldComparatorOption(): getMaxReduceTaskFailuresPercent() ,
Nearest to type(): mapProgress() , getProgress() ,
Nearest to getAllQueues(): getHistoryUrl() ,
Nearest to getReservedMapSlots(): getLen() , getOutputValueGroupingComparator() ,
Nearest to getBlacklistedTrackers(): getValue() ,
Nearest to getIncludeChildQueues(): createDecompressor() ,
Nearest to Module():
Nearest to clearChanged(): getPath() ,
Nearest to getMetricsCopy(): hasNext() , getApplicationTags() , getValue() , getBlockSize() ,
Nearest to homePathForCurrentUser(): getExitStatus() , getApplicationId() , isEnabled() , clearStatistics() ,
Nearest to getReduceTasks(): cleanupProgress() ,
Nearest to listSpanReceivers():
Nearest to resume(): values() , decr() ,
Nearest to getLen(): createValue() ,
Nearest to getSessionId(): getNodeId() , getPos() ,
Nearest to getOccupiedReduceSlots(): getDefaultBlockSize() ,
Nearest to getNeededResources():
Nearest to getReaders(): getLifecycleHistory() , iterator() ,
Nearest to getAllEvents(): getQueueState() , setRetired() , setNumMapTasks(int) ,
Nearest to getExitStatus(): homePathForCurrentUser() ,
Nearest to setRetired(): cleanupProgress() , getProfileParams() , setNumMapTasks(int) ,
Nearest to getAlgorithmName(): createTupleWritable() ,
Nearest to mark(): getEntityId() , isComplete() , getWorkingDirectory() , getBlackListedTaskTrackers() ,
Nearest to getVersion(): Input() ,
Nearest to getJobStatus(): getContainerIds() , getMemoryForReduceTask() , getStatus() , getUri() , getContextName() , getUser() ,
Nearest to isTypeConsumedAvailable(): getDirDefault() ,
Nearest to getContainersFromPreviousAttempts(): getConfiguration() ,
Nearest to getQueueAclsInfo(): getRootQueueInfos() , getId() ,
Nearest to getTaskTrackerCount(): getUriDefaultPort() , getMaxReduceAttempts() ,
Nearest to getDigester():
Nearest to getBlockDownloadLatency(): getModifiedTime() , getCompletedContainersStatuses() ,
Nearest to getOriginalTrackingUrl(): jobsToComplete() ,
Nearest to getJobLocalDir(): getContainerToken() , getConnection() ,
Nearest to getTaskTrackers(): getClassLoader() , getChildQueues() ,
Nearest to getSymlink(): isUriPathAbsolute() , getContainerLogDir() ,
Nearest to update():
Nearest to isDir(): createDirectDecompressor() , type() , getOutputKeyClass() ,
Nearest to getTaskCleanupNeeded(): getBlockSize() , getPos() , getFieldTypeInfos() , getGroup() ,
Nearest to getKeepTaskFilesPattern(): clear() , start() ,
Nearest to getBlackListedTaskTrackers(): getAvailableResources() , getType() , getResource() ,
Nearest to createTupleWritable(): getMaximumResourceCapability() , getAlgorithmName() , shutdown() , getNodeHttpAddress() , serviceStart() ,
Nearest to getScope(): getHost() ,
Nearest to getUpdatedNodes(): getFencer() , stop() ,
Nearest to createCheckpoint(): depth() , getIncludeChildQueues() , getOriginalTrackingUrl() , getOccupiedMapSlots() ,
Nearest to getNMTokens(): isAbsoluteAndSchemeAuthorityNull() , getConf() ,
Nearest to getStore(): depth() , getClusterNodeCount() ,
Nearest to getCreatedTime(): getKeyFieldPartitionerOption() ,
Nearest to getIncludePattern(): mapProgress() , getCompressorType() ,
Nearest to getRelaxLocality(): getFailedRequests() , incr() , getHistoryUrl() , not() ,
Nearest to getOutputValueGroupingComparator(): getFailureState() , getContainers() , getElementType() , getDisplayName() ,
Nearest to getReservationResources(): getApplicationAttemptId() , supportsSymlinks() ,
Nearest to getKeyFieldPartitionerOption(): type() ,
Nearest to getMaxVirtualMemoryForTask(): getJobFile() , getFailedRequests() ,
Nearest to getTokens(): getClusterStatus() ,
Nearest to getArchiveClassPaths(): getCumulativeVmem() , getSize() , getStatus() , getInputSplit() ,
Nearest to getEventType():
Nearest to getLogAggregationContext(): Include() ,
Nearest to getFileSystemInstanceId(): getCapability() , getDefaultExtension() ,
Nearest to generateParseException():
Nearest to getGraylistedTrackers(): getTaskTrackers() , getProgress() , getUriDefaultPort() ,
Nearest to isAbsoluteAndSchemeAuthorityNull(): getConf() , copyBytes() , get() , getNMTokens() ,
Nearest to getAccessTime(): getStatus() , end() , needsInput() , getOwner() ,
Nearest to getContextName(): isSuccessful() , getContainerIds() , getJobStatus() , getCachePoolDefault() ,
Nearest to getContainerExitStatus(): getPriority() ,
Nearest to getClusterMetrics():
Nearest to isTypeQuotaSet():
Nearest to getDefaultMaps():
Nearest to depth(): hasNext() ,
Nearest to getDecommissionedTaskTrackerCount(): getDisplayName() , getMaxMapTasks() , getProfileParams() , getFileSystem() , setNumMapTasks(int) , getAppId() , getBeginLine() ,
Nearest to getContextFactory(): getNodeHttpAddress() ,
Nearest to stopped(): getEndColumn() , getDigest() ,
Nearest to getBeginLine(): killJob() , getStartTime() , resetState() , getId() , flush() ,
Nearest to readChar():
Nearest to getRecordReaderQueue(): getDefaultExtension() , done() , getFinalParameters() ,
Nearest to getIncludeApplications(): waitForCompletion() , getMetricsCopy() ,
Nearest to usage():
Nearest to getNumClusterNodes():
Nearest to getRootQueueInfos(): getQueueAclsInfo() , getId() , disable_tracing() , isAbsoluteAndSchemeAuthorityNull() , getConfig() , getUsed() , getToken() , getFileSystem() ,
Nearest to getMaxMapTaskFailuresPercent():
Nearest to getJobEndNotificationURI(): Include() ,
Nearest to getFencer(): getResponseId() , getUpdatedNodes() , getConfig() , setupProgress() ,
Nearest to getCacheArchives(): getTaskTrackerCount() ,
Nearest to disable_tracing(): getUsed() , getLength() ,
Nearest to getCachePoolDefault(): clear() ,
Nearest to getTaskAttemptId(): getAccessTime() , getRMDelegationToken() ,
Nearest to getUnmanagedAM(): getMetricsCopy() ,
Nearest to startMonitoring():
Nearest to getJobACLs():
Nearest to getApplicationAttemptList(): getWorkingDirectory() , getCurrentKey() ,
Nearest to getProblems(): clear() ,
Nearest to getMetricNames():
Nearest to getDomains(): halfDigest() , getDelegate() ,
Nearest to getToken(): isAbsoluteAndSchemeAuthorityNull() , getReduceSlotCapacity() ,
Nearest to getFs(): getJobTrackerStatus() , getAllStatistics() , getResourceKey() ,
Nearest to getDiagnosticsInfo(): getType() , getSchedulingInfo() ,
Nearest to getConnection(): submit() , getJobLocalDir() , getLifecycleHistory() , getRpcPort() ,
Nearest to setNumMapTasks(int): setRetired() , getAllEvents() , getDecommissionedTaskTrackerCount() ,
Nearest to getKeyClass(): getDomains() , createCompressor() ,
Nearest to getMemory(): getEmptier() , getClusterNodeCount() ,
Nearest to getEntities(): decr() ,
Nearest to getStart(): getCompletedContainersStatuses() , jobsToComplete() ,
Nearest to getDefaultNodeLabelExpression(): getJobID() ,
Nearest to getDigest():
Nearest to getTaskId():
Nearest to webResponse(): submit() , getJobLocalDir() ,
Nearest to getTopologyPaths(): getCreationTime() ,
Nearest to getFileSystem(): get() ,
Nearest to getUsedMemory(): getCanonicalServiceName() , getDefaultNodeLabelExpression() ,
Nearest to getRMIdentifier(): getMaximumResourceCapability() ,
Nearest to getOutputFormat():
Nearest to getJobSetupCleanupNeeded():
Nearest to getTypeID(): finish() , getRawFileSystem() ,
Nearest to getEndColumn(): getUsed() , getNames() ,
Nearest to getReservedResources():
Nearest to getMapDebugScript(): getQueueName() , getUser() , getContainerLogDir() , getResourceKey() , getMemoryForReduceTask() , getStatus() , getQueue() , getFormatMinSplitSize() ,
Nearest to getNames(): usage() ,
